--------------------------------------------------------------------------------------------------------------------------------------------------------------------------------------------------------
--------------------------------------------------------------------------------------------------------------------------------------------------------------------------------------------------------
--------------------------------------------------------------------------------------------------------------------------------------------------------------------------------------------------------
--------------------------------------------------------------------------------------------------------------------------------------------------------------------------------------------------------
--------------------------------------------------------------------------------------------------------------------------------------------------------------------------------------------------------
------BB----------o--XX-----XXX---------------BB---------M--------------------------------------------------------BB-BBB-----o----o-----------o-----o--BXXXo----------------------o-X-----------BB------
----------------BB-----------o------------------------B---------o---------------M------------------?---------------------XX--o------?B-----------------------M----o--M-------M-------Mo------------BBB--
----------------------?-----------o---------------BB-o-M-----------------XX-------------------------o----------------------------------------BBBo-----------BBB--o------o------------------------------v
--------------------------------------------XX-----XX-----------------o--------XX----XX-o--o----------B---------------------BBXXX--------o-----o-----BB---------------------------------o-------XXBB---f
---------------------------o---?---------------------------o-------?-BBB--------XXX-----------------------------o-BBB----o-----------------o----------oBB---------------o-o-----------BB---------------f
--------------------------------------------------------------------------------------------------------------------------------------------------------------------------------------------------------
---------------------------------------T-------o-T-----------o---------------o---o--o----------T--o----------------------------------------o------------------------------------------------------------
--------T------------------------------|---------|---------------------------------------------|--------------------------------T------T----------------------------------------T------T----------------
--------|---E--------------------------|-------T-|-------------------E-------------------------|--T-----------------------------|------|--------------------------------------T-|------|-----E---------f
m-------|---------E-E------------------|-------|-|---------------------------------------------|--|-----------------------------|------|--------------------------------------|-|------|---------------X
XXXXXXXXXX-XXXXX-XXXXXXXX-XXXXXX--XXXXXXXXXXXX-XXXXXXX-XXX-XXXX-X--XX-XXXXXXXX-XX-XXXXXXX-XXXXXXXXXX-XXXXXXXXXXXXXXX-XXXXXXXXXXXXXXXXXXXX-XXXXXXXXXXXXXX--XXX-XXX-XXXX-X-XXXXXXXXXXXXXXXXX-XXXXXXXXXXXXX
